1 1 1 1 1 1 1 1 1 1 1 1 1 1 1 1 1 1 1 1 1 1 1 1 1 1 1 1 1 1 1 1 1 1 1 1 1 1 1 1 1 1 1 1 1 1 1 1 1 1
1 1 1 1 1 1 1 1 1 1 1 1 1 1 1 1 1 1 1 1 1 1 1 1 1 1 1 1 1 1 1 3 3 3 3 3 3 3 3 3 3 3 3 3 3 3 3 3 1 1
1 1 2 2 2 2 2 2 0 0 0 0 0 0 0 0 1 6 0 0 0 0 0 0 0 0 0 0 0 1 7 3 3 4 3 4 4 3 4 3 3 3 4 4 3 3 3 3 1 1
1 1 2 2 2 2 0 0 0 0 0 0 0 0 0 0 1 0 0 0 0 0 0 0 0 0 0 0 0 1 3 3 3 3 3 3 3 3 3 3 3 3 3 3 3 4 3 2 1 1
1 1 2 2 2 0 0 0 0 0 0 0 0 0 0 0 1 0 0 7 0 0 0 0 0 0 0 0 0 1 3 3 4 3 3 3 4 4 4 4 4 4 4 3 3 3 3 2 2 1
1 1 2 2 0 0 0 0 0 1 0 0 0 0 0 0 1 1 1 1 1 0 0 0 0 0 0 0 0 1 3 3 3 3 3 3 3 3 3 4 3 3 3 4 3 3 3 2 2 1
1 1 2 0 0 0 0 0 0 1 0 0 0 0 0 0 0 0 0 0 0 0 0 0 0 0 0 0 0 1 1 1 1 1 3 3 3 3 3 3 3 3 3 3 3 3 3 2 1 1
1 1 0 0 0 0 0 0 0 1 0 0 0 0 0 0 0 0 0 0 0 0 0 0 0 0 0 0 0 0 0 0 0 1 4 3 3 4 4 4 3 3 4 3 3 3 2 2 1 1
1 1 0 0 0 0 0 0 0 1 0 0 0 0 0 0 0 0 0 0 0 0 0 0 0 0 0 0 0 0 0 0 0 1 4 3 3 3 3 3 3 3 4 3 3 1 2 2 1 1
1 1 0 0 0 0 0 0 0 1 1 1 1 1 1 1 1 1 0 0 0 0 0 0 0 0 0 0 0 0 0 0 0 1 1 1 1 1 3 3 4 3 4 3 1 1 2 2 1 1
1 1 0 0 0 0 0 0 0 0 0 0 0 0 0 0 0 1 0 0 0 0 0 0 0 0 0 0 0 0 0 0 0 2 2 2 8 1 4 3 4 3 3 1 1 2 2 2 1 1
1 1 0 0 9 9 9 9 0 0 0 0 0 0 0 0 0 1 0 0 0 1 1 1 1 1 1 1 1 1 1 1 1 1 2 8 8 1 4 3 4 3 3 1 1 2 2 2 1 1
1 1 0 0 9 9 0 9 9 0 0 0 0 0 0 0 0 1 0 0 0 1 3 4 3 3 3 3 3 4 3 3 3 1 2 8 8 1 3 3 3 3 3 3 1 2 2 2 1 1
1 1 0 0 9 0 0 0 0 0 0 0 0 0 0 0 0 1 0 0 0 1 3 3 4 3 3 4 3 3 3 3 3 1 8 8 8 1 3 3 3 3 3 3 1 1 2 2 1 1
1 1 0 0 9 0 0 1 0 0 0 0 0 0 0 0 0 1 0 0 0 1 3 3 4 3 3 3 4 3 3 4 3 1 8 8 8 1 3 4 3 4 3 3 0 1 2 2 1 1
1 1 0 9 9 0 0 1 0 0 0 0 0 0 0 0 0 1 1 1 1 1 3 3 3 3 3 3 3 4 4 3 3 1 8 8 8 1 3 3 3 3 3 3 0 1 1 2 1 1
1 1 0 9 9 0 0 1 0 0 0 0 0 0 0 0 0 1 3 3 4 3 3 3 4 3 3 3 3 3 3 3 3 1 1 1 1 1 4 3 3 3 4 3 0 0 1 1 1 1
1 1 0 0 0 0 0 1 0 0 0 0 0 0 0 0 0 1 3 4 3 3 4 3 3 3 3 4 3 4 3 3 3 3 3 3 3 3 3 3 0 0 0 0 0 0 0 1 1 1
1 1 0 0 0 0 0 1 0 0 0 0 0 0 0 3 0 1 3 3 3 3 3 3 4 3 3 3 3 3 3 3 4 3 4 3 3 3 4 3 0 0 0 0 0 0 0 0 1 1
1 1 0 0 0 0 0 1 0 0 0 0 0 0 3 0 0 1 3 3 3 4 3 3 3 3 4 3 3 4 4 4 4 3 3 3 3 3 3 3 0 0 0 0 0 0 0 0 1 1
1 1 0 0 0 0 0 1 0 0 0 3 0 0 3 3 3 3 3 3 3 3 3 1 1 1 1 1 1 1 1 1 1 1 0 0 0 3 3 3 0 0 0 0 0 0 0 0 1 1
1 1 0 0 0 0 0 1 0 0 0 0 0 3 3 4 3 3 4 4 3 3 3 1 0 0 0 0 7 0 0 0 0 1 0 0 0 0 0 0 0 0 0 0 0 0 0 0 1 1
1 1 0 0 0 0 0 1 0 0 0 0 0 3 4 3 3 3 3 3 3 3 3 1 0 0 0 0 0 0 0 0 0 1 0 0 0 0 0 0 0 0 0 0 0 0 0 0 1 1
1 1 0 0 0 0 0 1 0 0 0 3 0 3 4 3 3 4 4 3 3 4 4 1 0 0 0 0 0 0 0 0 0 1 0 0 0 0 0 0 9 9 0 0 0 0 0 0 1 1
1 1 0 0 0 0 0 1 0 0 0 0 3 3 3 3 3 3 3 3 3 3 4 1 0 0 0 0 0 0 0 0 0 1 0 0 0 0 0 0 9 9 0 0 2 0 0 0 1 1
1 1 0 0 0 0 0 1 1 1 1 1 1 1 1 1 1 1 1 1 1 1 1 1 0 0 0 0 0 0 0 0 0 1 0 0 0 0 0 0 9 9 0 0 0 0 0 0 1 1
1 1 0 0 0 0 0 0 0 0 0 0 0 0 0 0 0 0 0 0 0 0 0 0 0 0 0 0 0 0 0 0 2 1 0 2 0 0 0 9 9 9 0 0 0 0 0 0 1 1
1 1 0 0 0 0 0 0 0 0 0 0 0 0 0 0 0 0 0 0 0 0 0 0 0 0 0 0 0 0 0 0 2 1 0 0 0 0 0 9 9 9 0 0 0 0 0 0 1 1
1 1 0 0 0 0 0 0 0 0 0 0 0 0 0 0 0 0 0 0 0 0 0 0 0 0 0 0 0 0 0 2 2 0 0 0 0 0 9 9 9 0 0 0 0 0 2 0 1 1
1 1 2 0 0 0 0 0 0 0 0 0 0 0 0 0 0 0 0 0 0 0 0 0 0 0 0 0 0 0 2 2 0 0 0 0 0 0 9 9 9 0 0 0 0 0 0 0 1 1
1 1 2 2 2 2 0 0 0 0 0 0 0 0 0 0 0 0 0 0 0 0 0 0 0 0 0 2 2 2 2 0 0 0 0 0 0 9 9 9 0 0 0 0 0 0 0 0 1 1
1 1 2 2 2 2 2 2 2 2 2 0 0 0 0 0 0 0 0 0 0 0 0 0 0 0 2 2 0 0 0 0 2 0 0 0 0 9 9 9 0 0 0 0 0 0 0 0 1 1
1 1 2 2 2 2 2 2 2 2 2 2 2 2 2 0 0 2 2 2 2 2 2 2 2 2 2 0 0 0 0 0 0 0 0 0 9 9 9 0 0 0 0 2 0 0 0 0 1 1
1 1 2 2 2 2 2 2 2 2 2 2 2 2 2 2 2 2 2 0 0 0 0 0 0 0 0 0 0 0 0 0 0 0 9 9 9 9 9 0 0 0 0 0 0 0 0 0 1 1
1 1 2 2 2 2 5 0 0 0 0 0 0 0 0 0 0 0 0 0 0 0 2 0 0 0 0 0 0 2 0 0 0 9 9 9 9 0 0 0 0 0 0 0 0 0 0 0 1 1
1 1 2 2 2 5 5 0 0 0 0 0 0 0 0 0 0 0 0 0 0 0 0 0 0 0 0 0 0 0 9 9 9 9 9 9 0 0 0 0 0 0 0 0 0 0 0 0 1 1
1 1 2 2 2 5 5 0 0 0 0 0 0 0 2 0 0 0 0 0 9 9 9 9 9 9 9 9 9 9 9 9 9 9 9 0 0 0 0 0 0 0 0 0 0 0 0 0 1 1
1 8 8 2 2 5 5 0 0 0 0 0 0 0 0 0 0 0 0 9 9 9 9 9 9 9 9 9 9 9 9 9 0 0 0 0 0 0 0 0 0 0 0 0 0 0 0 2 1 1
1 8 8 2 2 5 5 5 0 0 0 0 0 0 0 0 9 9 9 9 9 9 0 0 0 0 0 0 0 0 0 0 0 0 0 0 0 0 0 2 0 0 0 0 0 0 2 2 1 1
1 8 8 2 2 5 5 5 5 5 5 5 0 0 9 9 9 9 9 9 0 0 0 0 0 0 0 0 2 0 0 0 0 0 0 2 0 0 0 0 0 0 0 0 0 2 2 2 1 1
1 8 8 8 2 2 5 5 5 5 5 5 5 0 9 9 9 9 0 0 0 0 0 0 0 0 0 0 0 0 0 0 0 0 0 0 0 0 0 0 0 0 0 2 2 2 2 8 1 1
1 8 8 8 2 2 5 5 5 5 5 5 5 0 0 0 0 0 0 0 0 0 2 0 0 0 0 0 0 0 0 0 0 0 0 0 0 0 0 0 0 2 2 2 2 2 8 8 1 1
1 8 8 8 2 2 2 2 5 5 5 5 5 5 0 0 0 0 0 0 0 0 0 0 0 0 0 0 2 0 0 0 0 0 0 0 0 0 0 0 2 2 8 8 8 8 8 8 1 1
1 8 8 8 8 2 2 2 5 5 5 5 5 5 5 0 0 0 0 0 0 0 0 0 0 0 0 0 0 0 0 0 0 0 0 0 0 0 2 2 2 8 8 8 8 8 8 8 1 1
1 8 8 8 8 8 2 2 2 2 5 5 5 5 5 5 0 0 0 0 0 0 0 0 0 0 0 0 0 0 0 0 0 2 2 2 2 2 2 8 8 8 8 8 8 8 8 8 1 1
1 8 8 8 8 8 2 2 2 2 2 2 5 5 5 5 5 5 5 5 0 0 0 0 0 0 0 2 0 0 0 0 2 2 2 2 2 8 8 8 8 8 8 8 0 0 8 8 1 1
1 8 8 8 8 8 8 8 8 8 8 2 2 2 2 5 5 5 5 5 5 5 5 0 0 0 0 0 0 0 2 2 2 2 8 8 8 8 8 8 8 8 8 8 0 2 8 8 1 1
1 8 8 8 8 8 8 8 8 8 8 2 2 2 2 5 5 5 5 5 5 5 5 5 5 5 5 5 5 5 2 2 2 2 8 8 8 8 8 8 8 8 8 0 2 2 8 8 1 1
1 8 8 8 8 8 8 8 8 8 8 1 1 1 1 1 1 1 1 1 1 1 5 5 5 5 5 5 5 1 1 1 2 8 8 8 8 8 8 8 8 8 8 8 8 8 8 8 1 1
1 1 1 1 1 1 1 1 1 1 1 1 1 1 1 1 1 1 1 1 1 1 1 1 1 1 1 1 1 1 1 1 1 1 1 1 1 1 1 1 1 1 1 1 1 1 1 1 1 1