2 2 2 2 2 2 2 2 2 2 2 2 2 2 2 2 2 2 2 2 2 2 2 2 2 2 2 2 2 2 2 2 2 2 2 2 2 2 2 2 2 2 2 2 2 2 2 2 2 2
2 2 2 2 2 2 2 2 2 2 2 2 2 2 2 2 2 2 2 2 2 2 2 2 2 2 2 2 2 2 2 2 2 2 2 2 2 2 2 2 2 2 2 2 2 2 2 2 2 2
1 1 1 1 1 1 1 1 1 1 1 1 1 1 1 1 1 1 1 2 2 2 2 2 2 2 2 2 2 2 2 2 2 2 2 2 2 2 2 2 2 2 2 2 2 2 2 2 2 2
1 0 0 0 0 0 0 0 0 0 0 0 0 0 0 0 0 0 1 2 2 2 2 2 2 2 2 2 2 2 2 2 2 2 2 2 2 2 2 2 2 2 2 2 2 2 2 2 2 2
1 0 0 0 0 0 0 0 0 0 0 0 0 0 0 0 0 0 1 2 2 2 2 2 2 2 2 2 2 2 2 2 2 2 2 2 2 2 2 2 2 2 2 2 2 2 2 2 2 2
1 0 0 0 0 0 0 0 0 0 0 0 0 0 0 0 0 0 1 2 2 2 2 2 2 2 2 2 2 2 2 2 2 2 2 2 2 2 2 2 2 2 2 2 2 2 2 2 2 2
1 0 0 0 0 0 0 0 0 0 0 0 0 0 0 0 0 0 1 2 2 2 2 2 2 2 2 2 2 2 2 2 2 2 2 2 2 2 2 2 2 2 2 2 2 2 2 2 2 2
1 0 0 0 0 0 2 2 2 0 2 2 2 0 0 0 0 0 1 2 2 2 2 2 2 2 2 2 2 2 2 2 2 2 2 1 1 1 1 1 1 1 1 1 1 1 1 1 1 1
1 0 0 0 0 0 2 8 8 0 8 8 2 0 0 0 0 0 1 2 2 2 2 2 2 2 2 2 2 2 2 2 2 2 2 1 3 3 3 3 3 3 3 3 3 3 3 3 3 1
1 0 0 0 0 0 2 8 0 0 0 8 2 0 0 0 0 0 1 2 2 2 2 2 2 2 2 2 2 2 2 2 2 2 2 1 3 3 3 3 3 3 3 3 3 3 3 3 3 1
1 0 0 0 0 0 2 8 0 0 0 8 2 0 0 0 0 0 1 2 2 2 2 2 2 2 2 2 2 2 2 2 2 2 2 1 3 3 3 3 3 3 3 3 3 3 4 4 3 1
1 0 0 0 0 0 2 8 8 8 8 8 2 0 0 0 0 0 1 2 2 2 2 2 2 2 2 2 2 2 2 2 2 2 2 1 3 3 4 3 3 3 3 3 3 3 4 3 3 1
1 0 0 0 0 0 2 2 2 2 2 2 2 0 0 0 0 0 1 2 2 2 2 2 2 2 2 2 2 2 2 2 2 2 2 1 3 3 3 3 3 3 4 3 3 3 3 3 3 1
1 0 0 0 0 0 0 0 0 9 0 0 0 0 0 0 0 0 1 2 2 2 2 2 2 2 2 2 2 2 2 2 2 2 2 1 3 4 3 3 3 3 3 3 3 4 4 3 3 1
1 0 0 0 0 0 0 0 0 9 0 0 0 0 0 0 0 0 1 2 2 2 2 2 2 2 2 2 2 2 2 2 2 2 2 1 3 4 3 3 4 4 3 3 3 3 3 3 3 1
1 0 0 0 0 0 0 0 0 9 0 0 0 0 0 0 0 0 1 2 2 2 2 2 2 2 2 2 2 2 2 2 2 2 2 1 3 3 3 3 3 3 3 3 3 3 3 3 3 1
1 0 0 0 0 0 0 0 9 9 0 0 0 0 0 0 0 0 1 2 2 2 2 2 2 2 2 2 2 2 2 2 2 2 2 1 3 3 3 3 3 3 4 3 3 3 3 3 3 1
1 0 0 0 0 0 0 9 9 0 0 0 0 0 0 0 0 0 1 2 2 2 2 2 2 2 2 2 2 2 2 2 2 2 2 1 3 3 3 3 3 3 3 3 3 3 3 3 3 1
1 0 0 0 0 0 0 9 0 0 1 1 1 1 1 1 1 1 1 2 2 2 2 2 2 2 2 2 2 2 2 2 2 2 2 1 1 1 1 1 1 1 3 3 3 1 1 1 1 1
1 1 1 1 1 1 0 9 0 0 1 2 2 2 2 2 2 2 2 2 2 2 2 2 2 2 2 2 2 2 2 2 2 2 2 2 2 2 2 2 2 1 3 3 3 1 2 2 2 2
2 2 2 2 2 1 0 9 0 0 1 2 2 2 2 2 2 2 2 2 2 2 2 2 2 2 2 2 2 2 2 2 2 2 2 2 2 2 2 2 2 1 3 3 3 1 2 2 2 2
2 2 2 2 2 1 0 9 9 0 1 2 2 2 2 1 1 1 1 1 1 1 1 1 1 1 1 1 1 1 1 1 1 2 2 2 1 1 1 1 1 1 4 3 3 1 1 1 1 1
2 2 2 2 2 1 0 0 9 0 1 2 2 2 2 1 3 3 3 3 3 3 3 3 3 3 3 3 3 3 3 3 1 2 2 2 1 3 3 3 3 3 3 3 3 3 3 3 3 1
2 2 2 2 2 1 0 0 9 0 1 2 2 2 2 1 3 3 3 3 3 4 3 3 3 3 3 3 3 3 4 3 1 2 2 2 1 3 3 3 3 3 3 3 3 3 3 3 3 1
2 2 2 2 2 1 0 9 9 9 1 2 2 2 2 1 3 3 3 4 3 4 3 3 3 3 4 4 3 3 3 3 1 2 2 2 1 3 3 3 4 3 3 3 3 3 3 3 3 1
2 2 2 2 2 1 0 9 9 9 1 2 2 2 2 1 3 3 3 3 3 4 4 3 3 3 3 3 3 3 3 3 1 1 1 1 1 3 3 3 3 3 3 3 3 3 4 4 3 1
2 2 2 2 2 1 9 9 3 3 1 1 1 1 1 1 3 4 3 3 3 3 3 3 3 3 3 3 4 3 3 3 3 3 3 3 3 3 3 3 3 3 3 3 3 3 3 4 3 1
2 2 2 2 2 1 9 9 3 3 3 3 3 3 3 3 3 3 3 3 3 3 3 3 3 3 3 3 3 3 3 4 3 4 3 3 3 4 4 3 3 3 3 3 3 3 3 4 3 1
2 2 2 2 2 1 3 3 3 3 3 3 3 3 3 3 3 3 3 3 3 3 3 3 3 3 3 3 3 3 3 3 3 3 3 3 3 3 3 3 3 3 3 3 3 3 4 4 3 1
2 2 2 2 2 1 3 3 3 3 3 3 3 3 4 3 3 3 4 4 4 3 3 3 3 4 4 4 3 3 3 3 1 1 1 1 1 4 4 3 3 3 3 3 3 4 3 3 3 1
2 2 2 2 2 1 1 1 1 1 1 1 1 1 1 1 3 3 4 4 3 3 3 3 3 3 4 4 3 3 3 3 1 2 2 2 1 3 3 3 4 4 4 3 3 3 3 3 3 1
2 2 2 2 2 2 2 2 2 2 2 2 2 2 2 1 3 3 4 3 4 3 3 3 3 4 3 4 3 3 3 3 1 2 2 2 1 3 3 3 3 3 3 3 3 3 3 3 3 1
2 2 2 2 2 2 2 2 2 2 2 2 2 2 2 1 3 3 3 3 3 4 3 3 4 3 3 3 3 3 3 3 1 2 2 2 1 3 3 3 3 3 3 3 3 3 3 3 3 1
2 2 2 2 2 2 2 2 2 2 2 2 2 2 2 1 3 3 3 3 3 3 3 3 3 3 1 1 1 1 1 1 1 2 2 2 1 1 1 1 1 3 3 3 1 1 1 1 1 1
2 2 2 2 2 2 2 2 2 2 2 2 2 2 2 1 1 1 1 1 1 1 3 4 3 4 1 2 2 2 2 2 2 2 2 2 2 2 2 2 1 3 0 3 1 0 0 0 0 0
2 2 2 2 2 2 2 2 2 2 2 2 2 2 2 2 2 2 2 2 2 1 3 3 3 4 1 2 2 2 2 2 1 1 1 1 1 1 1 1 1 0 0 0 1 1 1 1 1 1
2 2 2 2 2 2 2 2 2 2 2 2 2 2 2 2 2 2 2 2 2 1 3 3 3 3 1 2 2 2 2 2 1 0 0 0 0 0 0 0 0 0 0 0 0 0 0 0 0 1
2 2 2 2 2 2 2 2 2 2 2 2 2 2 2 1 1 1 1 1 1 1 3 3 3 3 1 1 1 1 1 1 1 0 0 0 0 0 0 0 0 0 0 0 0 0 0 0 0 1
2 2 2 2 2 2 2 2 2 2 2 2 2 2 2 1 3 3 3 3 3 3 3 3 3 3 3 3 3 3 3 3 1 0 0 0 0 0 0 0 0 0 0 0 0 0 0 0 0 1
2 2 2 2 2 2 2 2 2 2 2 2 2 2 2 1 3 3 3 3 4 3 4 4 4 3 3 3 3 3 3 3 1 0 0 0 0 0 2 0 0 0 0 0 2 0 0 2 0 1
2 2 2 2 2 2 2 2 2 2 2 2 2 2 2 1 3 4 3 4 3 3 3 3 3 3 3 4 4 4 3 3 1 0 0 0 0 0 0 0 0 0 0 0 0 0 0 0 0 1
2 2 2 2 2 2 2 2 2 2 2 2 2 2 2 1 3 3 3 3 3 3 3 5 5 3 3 3 3 4 4 3 1 0 0 0 0 0 0 0 0 0 0 0 0 0 0 0 0 1
2 2 2 2 2 2 2 2 2 2 2 2 2 2 2 1 3 3 3 3 3 3 5 5 5 5 3 3 4 4 3 3 1 0 2 0 0 0 0 0 8 8 8 0 0 0 0 0 0 1
2 2 2 2 2 2 2 2 2 2 2 2 2 2 2 1 3 3 3 3 3 3 5 5 5 5 3 4 3 4 3 3 1 0 0 0 0 0 0 8 8 8 8 8 0 0 0 0 0 1
2 2 2 2 2 2 2 2 2 2 2 2 2 2 2 1 3 3 4 4 3 3 4 5 5 3 3 3 3 4 3 3 1 0 0 0 0 0 0 0 8 8 8 8 0 2 0 0 0 1
2 2 2 2 2 2 2 2 2 2 2 2 2 2 2 1 3 3 3 3 3 3 4 4 3 3 3 3 3 3 3 3 1 0 0 0 0 0 0 0 2 0 0 0 0 0 0 0 0 1
2 2 2 2 2 2 2 2 2 2 2 2 2 2 2 1 4 3 3 3 3 4 4 3 3 3 3 4 4 3 3 3 1 0 0 0 0 0 0 0 0 0 0 0 0 0 0 0 0 1
2 2 2 2 2 2 2 2 2 2 2 2 2 2 2 1 3 3 3 4 3 3 3 3 3 3 4 4 3 3 3 3 1 0 0 2 0 0 0 0 0 0 0 0 0 0 0 0 0 1
2 2 2 2 2 2 2 2 2 2 2 2 2 2 2 1 3 3 3 3 3 3 3 3 3 3 3 3 3 3 3 3 1 0 0 0 0 0 0 0 0 0 0 0 2 0 0 0 2 1
2 2 2 2 2 2 2 2 2 2 2 2 2 2 2 1 1 1 1 1 1 1 1 1 1 1 1 1 1 1 1 1 1 1 1 1 1 1 1 1 1 1 1 1 1 1 1 1 1 1
